//MAP CONVERTED BY dmm2tgm.py THIS HEADER COMMENT PREVENTS RECONVERSION, DO NOT REMOVE
"aa" = (
/turf/open/indestructible/ground/outside/desert,
/area/fallout/wasteland)
"ab" = (
/obj/structure/fence/corner{
	dir = 9;
	icon_state = "corner"
	},
/turf/open/indestructible/ground/outside/desert,
/area/fallout/wasteland)
"ac" = (
/obj/structure/fence{
	dir = 4;
	icon_state = "straight"
	},
/turf/open/indestructible/ground/outside/desert,
/area/fallout/wasteland)
"ad" = (
/turf/closed/wall/f13/wood/house,
/area/fallout/village)
"ae" = (
/obj/structure/window/fulltile/house{
	icon_state = "housewindowbrokenvertical"
	},
/obj/structure/barricade/wooden/planks/pregame,
/turf/open/floor/f13/wood,
/area/fallout/village)
"af" = (
/obj/structure/fence{
	dir = 8;
	icon_state = "straight"
	},
/turf/open/indestructible/ground/outside/desert,
/area/fallout/wasteland)
"ag" = (
/obj/structure/fence,
/turf/open/indestructible/ground/outside/desert,
/area/fallout/wasteland)
"ah" = (
/obj/structure/fermenting_barrel,
/turf/open/indestructible/ground/outside/dirt{
	icon_state = "dirtcorner"
	},
/area/fallout/wasteland)
"aj" = (
/mob/living/simple_animal/cow/brahmin,
/turf/open/indestructible/ground/outside/dirt{
	icon_state = "dirt"
	},
/area/fallout/wasteland)
"ak" = (
/turf/open/indestructible/ground/outside/dirt{
	icon_state = "dirt"
	},
/area/fallout/wasteland)
"al" = (
/turf/open/indestructible/ground/outside/dirt{
	dir = 8;
	icon_state = "dirtcorner"
	},
/area/fallout/wasteland)
"am" = (
/obj/structure/simple_door/house,
/turf/open/floor/f13/wood,
/area/fallout/village)
"an" = (
/turf/open/floor/f13/wood,
/area/fallout/village)
"ao" = (
/obj/machinery/light/small{
	dir = 1
	},
/turf/open/floor/f13/wood,
/area/fallout/village)
"ap" = (
/obj/structure/sink/kitchen{
	pixel_y = 28
	},
/turf/open/floor/f13/wood,
/area/fallout/village)
"aq" = (
/obj/machinery/light/small{
	dir = 1
	},
/obj/structure/closet/fridge,
/obj/item/reagent_containers/food/drinks/drinkingglass/shotglass,
/obj/item/reagent_containers/food/drinks/drinkingglass/shotglass,
/obj/item/reagent_containers/food/drinks/drinkingglass/shotglass,
/obj/item/reagent_containers/food/drinks/drinkingglass/shotglass,
/obj/item/reagent_containers/food/drinks/drinkingglass/shotglass,
/obj/item/reagent_containers/food/drinks/drinkingglass/shotglass,
/obj/effect/spawner/lootdrop/f13/alcoholspawner,
/obj/effect/spawner/lootdrop/f13/alcoholspawner,
/turf/open/floor/f13/wood,
/area/fallout/village)
"ar" = (
/obj/structure/closet/fridge,
/obj/item/reagent_containers/food/condiment/yeast,
/obj/item/reagent_containers/food/condiment/flour,
/obj/effect/spawner/lootdrop/f13/foodspawner,
/obj/effect/spawner/lootdrop/f13/foodspawner,
/turf/open/floor/f13/wood,
/area/fallout/village)
"as" = (
/turf/closed/wall/f13/wood/interior,
/area/fallout/village)
"at" = (
/obj/structure/chair/wood/fancy{
	dir = 4
	},
/turf/open/floor/f13/wood,
/area/fallout/village)
"au" = (
/obj/machinery/light/small{
	dir = 1
	},
/obj/effect/spawner/lootdrop/f13/alcoholspawner,
/obj/structure/table/wood/fancy,
/obj/item/reagent_containers/food/drinks/drinkingglass{
	pixel_y = 10
	},
/obj/item/reagent_containers/food/drinks/drinkingglass{
	pixel_y = 10
	},
/obj/effect/spawner/lootdrop/three_course_meal,
/turf/open/floor/f13/wood,
/area/fallout/village)
"av" = (
/obj/structure/chair/wood/fancy{
	dir = 8
	},
/turf/open/floor/f13/wood,
/area/fallout/village)
"aw" = (
/obj/machinery/light/small{
	dir = 1
	},
/obj/structure/closet/cabinet,
/obj/effect/spawner/lootdrop/clothing_middle,
/obj/item/clothing/shoes/singery,
/obj/item/clothing/under/singery,
/obj/item/clothing/under/f13/bartenderalt,
/obj/item/clothing/shoes/f13/fancy,
/obj/item/reagent_containers/food/drinks/flask,
/obj/item/toy/clockwork_watch,
/obj/effect/spawner/lootdrop/minor/kittyears_or_rabbitears,
/obj/effect/spawner/lootdrop/minor/bowler_or_that,
/turf/open/floor/f13/wood,
/area/fallout/village)
"ax" = (
/obj/structure/bed,
/obj/item/bedsheet{
	icon_state = "sheethos"
	},
/turf/open/floor/f13/wood,
/area/fallout/village)
"ay" = (
/turf/open/indestructible/ground/outside/dirt{
	icon_state = "dirtcorner"
	},
/area/fallout/farm)
"az" = (
/turf/open/indestructible/ground/outside/dirt{
	icon_state = "dirt"
	},
/area/fallout/farm)
"aA" = (
/turf/open/indestructible/ground/outside/dirt{
	dir = 8;
	icon_state = "dirtcorner"
	},
/area/fallout/farm)
"aC" = (
/turf/open/indestructible/ground/outside/dirt,
/area/fallout/wasteland)
"aD" = (
/mob/living/simple_animal/cow/brahmin,
/turf/open/indestructible/ground/outside/dirt,
/area/fallout/wasteland)
"aE" = (
/turf/open/indestructible/ground/outside/dirt{
	dir = 8;
	icon_state = "dirt"
	},
/area/fallout/wasteland)
"aF" = (
/mob/living/simple_animal/hostile/ghoul,
/turf/open/floor/f13/wood,
/area/fallout/village)
"aG" = (
/turf/open/floor/f13/wood{
	icon_state = "housewood2-broken"
	},
/area/fallout/village)
"aH" = (
/obj/structure/sink/well,
/turf/open/indestructible/ground/outside/dirt{
	dir = 4;
	icon_state = "dirt"
	},
/area/fallout/farm)
"aI" = (
/turf/open/indestructible/ground/outside/dirt,
/area/fallout/farm)
"aJ" = (
/turf/open/indestructible/ground/outside/dirt{
	dir = 8;
	icon_state = "dirt"
	},
/area/fallout/farm)
"aK" = (
/turf/open/indestructible/ground/outside/dirt{
	icon_state = "dirtcorner"
	},
/area/fallout/wasteland)
"aM" = (
/turf/open/indestructible/ground/outside/dirt{
	dir = 9;
	icon_state = "dirt"
	},
/area/fallout/wasteland)
"aN" = (
/mob/living/simple_animal/cow/brahmin,
/turf/open/indestructible/ground/outside/dirt{
	dir = 1;
	icon_state = "dirt"
	},
/area/fallout/wasteland)
"aO" = (
/turf/open/indestructible/ground/outside/dirt{
	dir = 1;
	icon_state = "dirtcorner"
	},
/area/fallout/wasteland)
"aP" = (
/obj/structure/table/wood,
/obj/machinery/reagentgrinder,
/turf/open/floor/f13/wood,
/area/fallout/village)
"aQ" = (
/obj/machinery/microwave/stove,
/turf/open/floor/f13/wood,
/area/fallout/village)
"aR" = (
/obj/structure/table/wood,
/turf/open/floor/f13/wood,
/area/fallout/village)
"aS" = (
/obj/structure/table/wood,
/obj/item/kitchen/rollingpin,
/turf/open/floor/f13/wood,
/area/fallout/village)
"aT" = (
/obj/structure/kitchenspike,
/turf/open/floor/f13/wood,
/area/fallout/village)
"aU" = (
/obj/structure/bookcase/random/adult,
/turf/open/floor/f13/wood,
/area/fallout/village)
"aV" = (
/obj/machinery/light/small,
/obj/structure/table/wood/settler,
/obj/item/paper_bin,
/obj/item/pen,
/turf/open/floor/f13/wood,
/area/fallout/village)
"aW" = (
/obj/structure/chair/wood{
	dir = 8
	},
/turf/open/floor/f13/wood,
/area/fallout/village)
"aX" = (
/turf/open/floor/f13/wood{
	icon_state = "housewood3-broken"
	},
/area/fallout/village)
"aY" = (
/obj/structure/table/wood/fancy,
/obj/item/restraints/handcuffs,
/obj/item/melee/chainofcommand/tailwhip/kitty,
/obj/item/dildo,
/turf/open/floor/f13/wood,
/area/fallout/village)
"aZ" = (
/turf/open/indestructible/ground/outside/dirt{
	dir = 4;
	icon_state = "dirt"
	},
/area/fallout/farm)
"ba" = (
/obj/structure/toilet,
/obj/machinery/light/small{
	dir = 1
	},
/obj/item/reagent_containers/food/snacks/f13/steak,
/obj/item/twohanded/sledgehammer,
/obj/effect/decal/remains/human,
/turf/open/floor/f13/wood,
/area/fallout/village)
"bb" = (
/turf/open/indestructible/ground/outside/dirt{
	dir = 4;
	icon_state = "dirtcorner"
	},
/area/fallout/wasteland)
"be" = (
/obj/structure/simple_door/room,
/turf/open/floor/f13/wood,
/area/fallout/village)
"bf" = (
/obj/structure/fence/corner{
	dir = 4;
	icon_state = "end"
	},
/turf/open/indestructible/ground/outside/desert,
/area/fallout/wasteland)
"bg" = (
/obj/structure/fence{
	dir = 8;
	icon_state = "straight"
	},
/turf/open/indestructible/ground/outside/dirt{
	dir = 4;
	icon_state = "dirt"
	},
/area/fallout/wasteland)
"bh" = (
/obj/structure/simple_door/metal/fence,
/turf/open/indestructible/ground/outside/dirt,
/area/fallout/wasteland)
"bi" = (
/obj/structure/fence{
	dir = 8;
	icon_state = "straight"
	},
/turf/open/indestructible/ground/outside/dirt{
	dir = 8;
	icon_state = "dirt"
	},
/area/fallout/wasteland)
"bj" = (
/obj/machinery/light/small{
	dir = 1
	},
/obj/effect/decal/cleanable/cobweb,
/turf/open/floor/f13/wood,
/area/fallout/village)
"bk" = (
/obj/structure/bed,
/obj/machinery/light/small{
	dir = 1
	},
/turf/open/floor/f13/wood,
/area/fallout/village)
"bl" = (
/obj/effect/decal/cleanable/blood,
/obj/effect/decal/cleanable/blood/gibs/body,
/obj/effect/decal/cleanable/blood/gibs{
	icon_state = "gibup1"
	},
/obj/effect/decal/cleanable/cobweb,
/turf/open/floor/f13/wood,
/area/fallout/village)
"bm" = (
/obj/effect/decal/cleanable/blood/tracks,
/turf/open/floor/f13/wood,
/area/fallout/village)
"bn" = (
/obj/structure/rack,
/obj/item/seeds/poppy/broc,
/obj/item/seeds/poppy/broc,
/obj/item/seeds/xander,
/obj/machinery/light/small{
	dir = 1
	},
/obj/item/seeds/xander,
/obj/item/seeds/wheat,
/obj/item/seeds/wheat,
/obj/item/seeds/tomato,
/obj/item/seeds/tomato,
/obj/item/seeds/sugarcane,
/obj/item/seeds/sugarcane,
/turf/open/floor/f13/wood,
/area/fallout/village)
"bo" = (
/obj/structure/rack,
/obj/item/shovel/spade,
/obj/item/shovel,
/obj/item/reagent_containers/glass/bucket,
/obj/item/cultivator,
/obj/item/storage/bag/plants,
/obj/item/scythe,
/turf/open/floor/f13/wood,
/area/fallout/village)
"bp" = (
/turf/open/indestructible/ground/outside/dirt{
	dir = 10;
	icon_state = "dirt"
	},
/area/fallout/farm)
"bq" = (
/obj/structure/chair/wood{
	dir = 1
	},
/turf/open/floor/f13/wood,
/area/fallout/village)
"br" = (
/turf/open/indestructible/ground/outside/dirt{
	dir = 4;
	icon_state = "dirt"
	},
/area/fallout/wasteland)
"bs" = (
/obj/structure/chair/wood,
/turf/open/floor/f13/wood,
/area/fallout/village)
"bt" = (
/obj/structure/window/fulltile/house{
	dir = 2;
	icon_state = "housewindow"
	},
/obj/structure/barricade/wooden/planks/pregame,
/turf/open/floor/f13/wood,
/area/fallout/village)
"bu" = (
/obj/machinery/hydroponics/soil,
/turf/open/indestructible/ground/outside/dirt,
/area/fallout/farm)
"bv" = (
/obj/structure/car,
/turf/open/indestructible/ground/outside/desert,
/area/fallout/wasteland)
"bw" = (
/mob/living/simple_animal/hostile/ghoul,
/turf/open/floor/f13/wood{
	icon_state = "housewood3-broken"
	},
/area/fallout/village)
"bx" = (
/obj/effect/decal/cleanable/blood/gibs/body,
/turf/open/floor/f13/wood,
/area/fallout/village)
"by" = (
/obj/structure/bed,
/obj/item/bedsheet{
	icon_state = "sheetgrey"
	},
/turf/open/floor/f13/wood,
/area/fallout/village)
"bz" = (
/obj/effect/decal/cleanable/blood/tracks,
/mob/living/simple_animal/hostile/ghoul,
/turf/open/floor/f13/wood,
/area/fallout/village)
"bA" = (
/mob/living/simple_animal/hostile/ghoul/reaver,
/turf/open/floor/f13/wood,
/area/fallout/village)
"bB" = (
/turf/open/indestructible/ground/outside/dirt{
	dir = 10;
	icon_state = "dirt"
	},
/area/fallout/wasteland)
"bC" = (
/obj/structure/table/wood/settler,
/obj/effect/spawner/lootdrop/f13/weapon/gun/ballistic/low,
/turf/open/floor/f13/wood,
/area/fallout/village)
"bD" = (
/turf/open/indestructible/ground/outside/dirt{
	dir = 6;
	icon_state = "dirt"
	},
/area/fallout/wasteland)
"bE" = (
/obj/machinery/light/small{
	dir = 1
	},
/turf/open/floor/f13/wood{
	icon_state = "housewood3-broken"
	},
/area/fallout/village)
"bG" = (
/obj/effect/decal/cleanable/blood/splatter,
/turf/open/floor/f13/wood,
/area/fallout/village)
"bH" = (
/turf/open/indestructible/ground/outside/dirt{
	dir = 1;
	icon_state = "dirt"
	},
/area/fallout/wasteland)
"bI" = (
/obj/structure/simple_door/room,
/obj/structure/barricade/wooden/planks,
/turf/open/floor/f13/wood,
/area/fallout/village)
"bJ" = (
/obj/machinery/light/small,
/turf/open/floor/f13/wood,
/area/fallout/village)
"bK" = (
/obj/effect/decal/cleanable/blood,
/turf/open/floor/f13/wood{
	icon_state = "housewood3-broken"
	},
/area/fallout/village)
"bL" = (
/obj/item/reagent_containers/glass/bucket,
/obj/machinery/hydroponics/soil,
/turf/open/indestructible/ground/outside/dirt,
/area/fallout/farm)
"bM" = (
/obj/structure/car/rubbish3,
/turf/open/indestructible/ground/outside/desert,
/area/fallout/wasteland)
"bN" = (
/obj/structure/bed/mattress,
/turf/open/floor/f13/wood,
/area/fallout/village)
"bO" = (
/obj/structure/table/wood/settler,
/turf/open/floor/f13/wood,
/area/fallout/village)
"bP" = (
/obj/structure/rack,
/obj/effect/spawner/lootdrop/f13/armor/costumes,
/turf/open/floor/f13/wood,
/area/fallout/village)
"bQ" = (
/obj/machinery/light/small{
	dir = 1
	},
/obj/structure/rack,
/obj/effect/spawner/lootdrop/trash,
/turf/open/floor/f13/wood,
/area/fallout/village)
"bR" = (
/obj/structure/rack,
/obj/effect/spawner/lootdrop/f13/cash_random_low,
/turf/open/floor/f13/wood,
/area/fallout/village)
"bS" = (
/obj/machinery/light/small{
	dir = 1
	},
/obj/structure/rack,
/obj/effect/spawner/lootdrop/f13/weapon/gun/ballistic/low,
/turf/open/floor/f13/wood,
/area/fallout/village)
"bT" = (
/obj/structure/rack,
/obj/effect/spawner/lootdrop/f13/armor/random,
/turf/open/floor/f13/wood,
/area/fallout/village)
"bU" = (
/obj/item/seeds/poppy/broc,
/obj/machinery/hydroponics/soil,
/turf/open/indestructible/ground/outside/dirt,
/area/fallout/farm)
"bV" = (
/mob/living/simple_animal/hostile/ghoul,
/turf/open/floor/f13/wood{
	icon_state = "housewood4-broken"
	},
/area/fallout/village)
"bW" = (
/obj/structure/fermenting_barrel,
/turf/open/indestructible/ground/outside/dirt{
	dir = 4;
	icon_state = "dirtcorner"
	},
/area/fallout/farm)
"bX" = (
/obj/structure/rack,
/obj/effect/spawner/lootdrop/f13/medical/wasteland/meds,
/turf/open/floor/f13/wood,
/area/fallout/village)
"bY" = (
/turf/open/indestructible/ground/outside/dirt{
	dir = 1;
	icon_state = "dirt"
	},
/area/fallout/farm)
"bZ" = (
/turf/open/indestructible/ground/outside/dirt{
	dir = 1;
	icon_state = "dirtcorner"
	},
/area/fallout/farm)
"ca" = (
/obj/structure/rack,
/obj/effect/spawner/lootdrop/f13/medical/wasteland/meds,
/turf/open/floor/f13/wood{
	icon_state = "housewood4-broken"
	},
/area/fallout/village)
"cb" = (
/turf/open/floor/f13/wood{
	icon_state = "housewood4-broken"
	},
/area/fallout/village)
"cc" = (
/obj/effect/decal/cleanable/blood/gibs/limb,
/turf/open/floor/f13/wood,
/area/fallout/village)
"cd" = (
/obj/structure/bed/mattress,
/obj/effect/decal/cleanable/cobweb/cobweb2,
/turf/open/floor/f13/wood,
/area/fallout/village)

(1,1,1) = {"
aa
aa
aa
aa
aK
bb
aa
aa
aa
ak
aC
bH
bM
aa
aa
aa
aa
"}
(2,1,1) = {"
aa
aa
aa
aa
al
aO
aa
aa
bv
ak
aC
bH
aa
aa
aa
aa
aa
"}
(3,1,1) = {"
aa
ab
ag
ag
ag
ag
bf
aa
aa
ak
aC
bH
aa
aa
aa
aa
aa
"}
(4,1,1) = {"
aa
ac
ah
br
br
br
bg
br
br
bD
aC
bH
aa
aa
aa
aa
aa
"}
(5,1,1) = {"
aa
ac
ak
aC
aC
aC
bh
aC
aC
aC
aC
bH
aa
aa
aa
aa
aa
"}
(6,1,1) = {"
aa
ac
aj
aC
aM
aE
bi
aE
aE
bB
aC
bH
aa
aa
aa
aa
aa
"}
(7,1,1) = {"
aa
ac
ak
aD
aN
ad
ad
ae
ad
ad
bI
ad
ad
aa
aa
aa
aa
"}
(8,1,1) = {"
aa
ac
al
aE
aO
ad
bj
an
an
as
an
an
ad
aa
aa
aa
aa
"}
(9,1,1) = {"
aa
ad
am
ad
ad
ad
aW
an
an
as
an
aG
ad
ad
ad
ad
ad
"}
(10,1,1) = {"
aa
ad
an
an
aP
as
an
an
an
as
bE
an
as
bN
an
bN
ad
"}
(11,1,1) = {"
aa
ad
ao
cb
aQ
as
bk
an
by
as
an
aX
as
an
bV
aX
ad
"}
(12,1,1) = {"
aa
ae
an
an
aR
as
as
be
as
as
an
as
as
bN
aG
bN
ad
"}
(13,1,1) = {"
aa
ad
ap
an
aS
as
bl
bm
bz
an
an
cc
be
an
aX
bV
ae
"}
(14,1,1) = {"
aa
ad
aq
aG
an
be
an
bw
an
bG
aF
an
as
ao
an
an
ad
"}
(15,1,1) = {"
aa
ad
ar
an
aT
as
an
bs
bO
bO
an
an
as
cd
an
bN
ad
"}
(16,1,1) = {"
aa
ad
as
as
as
as
aF
an
bA
aW
bK
an
as
as
as
as
ad
"}
(17,1,1) = {"
aa
ad
at
an
an
be
an
bx
an
aF
an
an
as
bP
an
bX
ae
"}
(18,1,1) = {"
aa
ad
au
aG
aU
as
as
as
as
as
be
as
as
bQ
aG
bT
ad
"}
(19,1,1) = {"
aa
ad
av
an
aV
as
an
bs
bC
bq
an
bJ
as
bR
an
ca
ad
"}
(20,1,1) = {"
aa
ad
an
an
aW
as
an
an
an
aX
an
an
be
an
aF
bP
ae
"}
(21,1,1) = {"
aa
ad
aw
an
aX
as
bn
an
cb
aG
an
an
as
bS
an
bP
ad
"}
(22,1,1) = {"
aa
ad
ax
an
aY
as
bo
an
an
aF
an
an
as
bT
an
bT
ad
"}
(23,1,1) = {"
aa
ad
ad
ad
ad
ad
ad
bt
bt
ad
am
ad
ad
ad
bt
ad
ad
"}
(24,1,1) = {"
aa
af
ay
aH
aZ
aZ
aZ
aZ
aZ
aZ
aZ
aZ
aZ
aZ
bW
af
aa
"}
(25,1,1) = {"
aa
af
az
aI
aI
aI
aI
bu
aI
bu
aI
bu
aI
bu
bY
af
aa
"}
(26,1,1) = {"
aa
af
aA
aJ
aJ
aJ
bp
bu
aI
bu
aI
bu
aI
bu
bY
af
aa
"}
(27,1,1) = {"
aa
af
aa
ad
ad
ad
az
aI
aI
aI
aI
aI
aI
aI
bY
af
aa
"}
(28,1,1) = {"
aa
af
aa
ad
ba
am
az
bu
aI
bu
aI
bL
aI
bU
bY
af
aa
"}
(29,1,1) = {"
aa
af
aa
ad
ad
ad
az
bu
aI
bu
aI
bu
aI
bu
bY
af
aa
"}
(30,1,1) = {"
aa
af
aa
aa
aa
aa
aA
aJ
aJ
aJ
aJ
aJ
aJ
aJ
bZ
af
aa
"}
